Level two
---
xxxxxxx
x.....x
x.s...x
x...b.x
x.....x
xxx.xxx