First Level
---
xxxxxxxxxxxxx
x...........x
x.s...m.....x
x...b......mx
x......xx...x
xxx.xx..x...xxxxxxx
xxx.xxx...........x
x.....x....m...e..x
x.m.....ww........x
x...b.x........e..x
x.....x...........x
xxx.xxxx.xxxxxxxxxx
xxx.xxx..x
x.f.f...xx
x.w...xxx
x...b.x
x.....x
xxxxxxx
---