First Level
---
xxxxxxx
x.....x
x.s...x
x...b.xx
x......xx
xxx.xx..xxxxxxxxxxx
xxx.xxx...........x
x.....x........e..x
x.m.....ww........x
x...b.x........e..x
x.....x...........x
xxx.xxxx.xxxxxxxxxx
xxx.xxx..x
x.f.f...xx
x.w...xxx
x...b.x
x.....x
xxxxxxx
---END