xxxxxxx
x.....x
x.s...x
x...b.x
x.....x
xxx.xxx
xxx.xxx
x.....x
x.m...x
x...b.x
x.....x
xxx.xxx
xxx.xxx
x.f.f.x
x.w...x
x...b.x
x.....x
xxxxxxx