xxxxxxx
x.....x
x.s...x
x...b.x
x.....x
xxx.xxxxxxxxxxxxxxx
xxx.xxx...........x
x.....x...........x
x.m.....ww........x
x...b.x...........x
x.....x...........x
xxx.xxxxxxxxxxxxxxx
xxx.xxx
x.f.f.x
x.w...x
x...b.x
x.....x
xxxxxxx